##########
# P   K  #
#        #
#    #####
#    # S D
#    #   #
#  M #   #
#    #   #
#     S  #
####D#####